1 1 1 1 1 1 1 1 1 1 1 1 1 1 1 1 1
1 0 1 0 1 0 1 0 2 0 1 0 1 0 1 0 1 
1 1 1 1 1 1 1 1 1 1 1 1 1 1 1 1 1
1 0 1 0 1 0 1 0 1 0 1 GH 2 0 1 0 1
1 1 1 1 1 1 1 1 1 1 1 2 2 1 1 1 1
1 0 2 RS 1 0 1 0 1 0 1 0 1 0 1 0 1
1 1 2 2 1 1 1 1 1 1 1 1 1 1 1 1 1
1 0 1 0 1 0 1 0 1 0 1 0 1 0 1 0 1
1 2 1 1 1 1 1 1 1 1 1 1 2 2 1 1 1
1 0 1 0 1 0 1 0 1 0 1 0 2 YC 1 0 1
1 1 1 1 1 1 1 1 1 1 1 1 1 1 1 1 1
1 0 1 0 1 0 1 0 1 0 1 0 1 0 1 0 1 
1 1 1 1 1 2 2 1 1 1 1 1 1 1 1 1 1
1 0 1 0 1 BT 2 0 1 0 1 0 1 0 1 0 1
1 1 1 1 1 1 1 1 1 1 1 1 1 1 2 2 1
1 0 1 0 1 0 1 0 1 0 1 0 1 0 2 X 1
1 1 1 1 1 1 1 1 1 1 1 1 1 1 1 1 1
