1 1 1 1 1 1 1 1 1 1 1 1 1 1 1 1 1
1 0 1 0 1 0 1 0 2 0 1 0 1 0 1 0 1
1 1 1 1 1 1 1 1 1 1 1 1 1 1 1 1 1
1 0 2 RT 1 0 1 0 1 0 1 0 1 0 1 0 1
1 1 2 2 1 1 1 1 1 1 1 1 1 2 2 1 1
1 0 1 0 1 0 1 0 1 0 1 0 1 GC 2 0 1
1 1 1 1 1 1 1 1 1 1 1 1 1 1 1 1 1
1 0 1 0 1 0 1 0 1 0 1 0 1 0 1 0 1
1 1 1 1 1 1 1 1 1 1 1 1 1 1 1 1 1
1 0 1 0 1 BH 2 0 1 0 1 0 1 0 1 0 1
1 1 1 1 1 2 2 1 1 1 1 1 1 1 2 2 1 
1 0 1 0 1 0 1 0 1 0 1 0 1 0 2 YS 1 
1 2 1 1 1 1 1 1 1 1 1 1 1 1 1 1 1 
1 0 1 0 1 0 1 0 1 0 1 0 1 0 1 0 1 
1 1 1 1 1 1 1 1 1 1 1 1 1 1 2 2 1
1 0 1 0 1 0 1 0 1 0 1 0 1 0 2 X 1
1 1 1 1 1 1 1 1 1 1 1 1 1 1 1 1 1