1 1 1 1 1 1 1 1 1 1 1 1 1 1 1 1 1
1 0 1 0 2 0 1 0 1 0 1 0 1 0 1 0 1
1 1 1 1 1 1 1 1 2 2 1 1 1 1 1 1 1
1 0 1 0 1 0 1 0 2 RC 1 0 1 0 1 0 1
1 1 1 2 2 1 1 1 1 1 1 1 1 1 1 1 1
1 0 1 GT 2 0 1 0 1 0 1 0 1 0 1 0 1
1 1 1 1 1 1 1 1 1 1 1 1 1 1 1 1 1
1 0 1 0 1 0 1 0 1 0 1 0 1 YH 2 0 1
1 1 1 1 1 1 1 1 1 1 1 1 1 2 2 1 1
1 0 1 0 1 0 1 0 1 0 1 0 1 0 1 0 1
1 1 1 1 1 1 1 1 1 1 1 1 1 1 1 1 1
1 0 1 0 1 0 1 0 1 0 1 0 1 0 1 0 1
1 2 1 1 1 1 1 1 1 1 1 1 1 1 1 1 1
1 0 1 0 1 0 2 BS 1 0 1 0 1 0 1 0 1 
1 1 1 1 1 1 2 2 1 1 1 1 1 1 2 2 1
1 0 1 0 1 0 1 0 1 0 1 0 1 0 2 X 1
1 1 1 1 1 1 1 1 1 1 1 1 1 1 1 1 1