1 1 1 1 1 1 1 1 1 1 1 1 1 1 1 1 1
1 0 1 0 1 0 1 0 1 0 2 0 1 0 1 0 1
1 1 1 1 1 1 1 1 1 1 1 1 1 1 1 1 1 
1 0 1 0 1 0 1 0 1 0 1 0 1 YH 2 0 1
1 1 2 2 1 1 1 1 1 1 1 1 1 2 2 1 1
1 0 2 GT 1 0 1 0 1 0 1 0 1 0 1 0 1
1 1 1 1 1 1 1 1 1 1 1 1 1 1 1 1 1
1 0 1 0 1 0 1 0 1 0 1 0 1 0 1 0 1
1 1 1 1 1 1 1 1 1 1 1 1 1 1 1 1 1
1 0 1 0 1 0 1 0 1 0 1 0 1 0 1 0 1
1 1 1 1 1 1 1 1 1 1 1 1 1 2 2 1 1
1 0 1 0 1 0 1 0 1 0 1 0 1 BS 2 0 1
1 2 1 1 1 1 1 1 1 1 1 1 1 1 1 1 1 
1 0 1 0 1 0 2 RC 1 0 1 0 1 0 1 0 1
1 1 1 1 1 1 2 2 1 1 1 1 1 1 2 2 1
1 0 1 0 1 0 1 0 1 0 1 0 1 0 2 X 1
1 1 1 1 1 1 1 1 1 1 1 1 1 1 1 1 1