1 1 1 1 1 1 1 1 1 1 1 1 1 1 1 1 1
1 0 1 0 1 0 1 0 1 0 2 0 1 0 1 0 1
1 1 1 1 1 1 1 1 1 1 1 1 1 1 1 1 1
1 0 1 0 1 RH 2 0 1 0 1 0 1 0 1 0 1 
1 1 1 1 1 2 2 1 1 1 1 1 1 1 1 1 1
1 0 1 0 1 0 1 0 1 0 1 0 1 0 1 0 1
1 1 1 1 1 1 1 1 1 1 1 1 1 1 1 1 1
1 0 2 GS 1 0 1 0 1 0 1 0 1 0 1 0 1
1 1 2 2 1 1 1 1 1 1 1 1 2 2 1 1 1
1 0 1 0 1 0 1 0 1 0 1 0 2 YT 1 0 1 
1 2 1 1 1 1 1 1 1 1 1 1 1 1 1 1 1
1 0 1 0 1 0 1 0 1 0 1 0 1 0 1 0 1
1 1 1 1 1 1 1 1 1 1 1 2 2 1 1 1 1
1 0 1 0 1 0 1 0 1 0 1 0 2 0 1 0 1
1 1 1 1 1 1 1 1 1 1 1 1 1 1 2 2 1
1 0 1 0 1 0 1 Rain 2 0 1 0 1 BC 2 X 1
1 1 1 1 1 1 1 2 2 1 1 1 1 1 1 2 1
