1 1 1 1 1 1 1 1 1 1 1 1 1 1 1 1 1
1 0 1 0 1 0 1 0 2 0 1 0 1 0 1 0 1
1 1 1 1 1 1 1 1 1 1 1 1 1 1 1 1 1 
1 0 1 0 1 0 1 0 1 0 1 0 2 BC 1 0 1
1 1 1 1 1 1 1 1 1 1 1 1 2 2 1 1 1
1 0 1 0 1 0 1 0 1 0 1 0 1 0 1 0 1
1 1 1 2 2 1 1 1 1 1 1 1 1 1 1 1 1
1 0 1 YT 2 0 1 0 1 0 1 0 1 0 1 0 1
1 1 1 1 1 1 1 1 1 1 2 2 1 1 1 1 1
1 0 1 0 1 0 1 0 1 0 2 GS 1 0 1 0 1
1 1 1 1 1 1 1 1 1 1 1 1 1 1 1 1 1
1 0 1 0 1 RH 2 0 1 0 1 0 1 0 1 Rain 2
1 1 1 1 1 2 2 1 1 1 1 1 1 1 1 2 2
1 0 1 0 1 0 1 0 1 0 1 0 1 0 1 0 1
1 2 1 1 1 1 1 1 1 1 1 1 1 1 2 2 1 
1 0 1 0 1 0 1 0 1 0 1 0 1 0 2 X 1
1 1 1 1 1 1 1 1 1 1 1 1 1 1 1 1 1
