<map1>
1 1 1 1 1 1 1 1 1 1 1 1 1 1 1 1 1
1 0 1 0 1 0 1 0 1 0 2 0 1 0 1 0 1
1 1 1 1 2 2 1 1 1 1 1 1 1 1 1 1 1
1 0 1 0 2 YC 1 0 1 0 1 0 1 0 1 0 1
1 1 1 1 1 1 1 1 1 1 1 1 1 1 1 1 1 
1 0 1 0 1 0 1 0 1 0 1 0 1 0 1 0 1
1 1 1 1 1 1 1 1 1 1 1 1 1 1 1 1 1
1 0 1 0 1 0 1 0 1 0 1 0 2 BT 1 0 1
1 1 1 1 1 1 1 1 1 1 1 1 2 2 1 1 1
1 0 1 0 1 0 1 0 1 0 1 0 1 0 1 0 1
1 2 1 1 1 1 1 1 1 2 2 1 1 1 1 1 1
1 0 1 0 1 0 1 0 1 RS 2 0 1 0 1 0 1
1 1 1 1 1 1 1 1 1 1 1 1 1 1 1 1 1
1 0 1 GH 2 0 1 0 1 0 1 0 1 0 1 0 1
1 1 1 2 2 1 1 1 1 1 1 1 1 1 2 2 1
1 0 1 0 1 0 1 0 1 0 1 0 1 0 2 X 1
1 1 1 1 1 1 1 1 1 1 1 1 1 1 1 1 1

<map2>
1 1 1 1 1 1 1 1 1 1 1 1 1 1 1 1 1
1 0 1 0 1 0 1 0 2 0 1 0 1 0 1 0 1 
1 1 1 1 1 1 1 1 1 1 1 1 1 1 1 1 1
1 0 1 0 1 0 1 0 1 0 1 GH 2 0 1 0 1
1 1 1 1 1 1 1 1 1 1 1 2 2 1 1 1 1
1 0 2 RS 1 0 1 0 1 0 1 0 1 0 1 0 1
1 1 2 2 1 1 1 1 1 1 1 1 1 1 1 1 1
1 0 1 0 1 0 1 0 1 0 1 0 1 0 1 0 1
1 2 1 1 1 1 1 1 1 1 1 1 2 2 1 1 1
1 0 1 0 1 0 1 0 1 0 1 0 2 YC 1 0 1
1 1 1 1 1 1 1 1 1 1 1 1 1 1 1 1 1
1 0 1 0 1 0 1 0 1 0 1 0 1 0 1 0 1 
1 1 1 1 1 2 2 1 1 1 1 1 1 1 1 1 1
1 0 1 0 1 BT 2 0 1 0 1 0 1 0 1 0 1
1 1 1 1 1 1 1 1 1 1 1 1 1 1 2 2 1
1 0 1 0 1 0 1 0 1 0 1 0 1 0 2 X 1
1 1 1 1 1 1 1 1 1 1 1 1 1 1 1 1 1

<map3>
1 1 1 1 1 1 1 1 1 1 1 1 1 1 1 1 1
1 0 1 0 1 0 1 0 2 0 1 0 1 0 1 0 1
1 1 1 1 1 1 1 1 1 1 1 1 1 1 1 1 1
1 0 2 RT 1 0 1 0 1 0 1 0 1 0 1 0 1
1 1 2 2 1 1 1 1 1 1 1 1 1 2 2 1 1
1 0 1 0 1 0 1 0 1 0 1 0 1 GC 2 0 1
1 1 1 1 1 1 1 1 1 1 1 1 1 1 1 1 1
1 0 1 0 1 0 1 0 1 0 1 0 1 0 1 0 1
1 1 1 1 1 1 1 1 1 1 1 1 1 1 1 1 1
1 0 1 0 1 BH 2 0 1 0 1 0 1 0 1 0 1
1 1 1 1 1 2 2 1 1 1 1 1 1 1 2 2 1 
1 0 1 0 1 0 1 0 1 0 1 0 1 0 2 YS 1 
1 2 1 1 1 1 1 1 1 1 1 1 1 1 1 1 1 
1 0 1 0 1 0 1 0 1 0 1 0 1 0 1 0 1 
1 1 1 1 1 1 1 1 1 1 1 1 1 1 2 2 1
1 0 1 0 1 0 1 0 1 0 1 0 1 0 2 X 1
1 1 1 1 1 1 1 1 1 1 1 1 1 1 1 1 1

<map4>
1 1 1 1 1 1 1 1 1 1 1 1 1 1 1 1 1
1 0 1 0 1 0 1 0 2 0 1 0 1 0 1 0 1
1 1 1 1 1 1 1 1 1 1 1 1 1 1 1 1 1 
1 0 1 0 1 0 1 0 1 0 1 0 1 0 1 0 1
1 1 1 1 1 1 1 1 1 1 1 1 1 1 1 1 1
1 0 1 0 1 0 1 0 1 0 1 BH 2 0 1 0 1
1 1 1 1 1 1 1 1 1 1 1 2 2 1 1 1 1
1 0 1 0 1 0 1 0 1 0 1 0 1 0 1 0 1
1 1 1 1 1 2 2 1 1 1 1 1 1 1 1 1 1
1 0 1 0 1 GC 2 0 1 0 1 0 1 0 1 0 1
1 2 1 1 1 1 1 1 1 1 1 1 1 1 1 1 1
1 0 1 0 1 0 1 0 1 0 1 0 1 0 2 RT 1
1 1 2 2 1 1 1 1 1 1 1 1 1 1 2 2 1
1 0 2 YS 1 0 1 0 1 0 1 0 1 0 1 0 1
1 1 1 1 1 1 1 1 1 1 1 1 1 1 2 2 1
1 0 1 0 1 0 1 0 1 0 1 0 1 0 2 X 1
1 1 1 1 1 1 1 1 1 1 1 1 1 1 1 1 1 

<map5>
1 1 1 1 1 1 1 1 1 1 1 1 1 1 1 1 1
1 0 1 0 2 0 1 0 1 0 1 0 1 0 1 0 1
1 1 1 1 1 1 1 1 2 2 1 1 1 1 1 1 1
1 0 1 0 1 0 1 0 2 RC 1 0 1 0 1 0 1
1 1 1 2 2 1 1 1 1 1 1 1 1 1 1 1 1
1 0 1 GT 2 0 1 0 1 0 1 0 1 0 1 0 1
1 1 1 1 1 1 1 1 1 1 1 1 1 1 1 1 1
1 0 1 0 1 0 1 0 1 0 1 0 1 YH 2 0 1
1 1 1 1 1 1 1 1 1 1 1 1 1 2 2 1 1
1 0 1 0 1 0 1 0 1 0 1 0 1 0 1 0 1
1 1 1 1 1 1 1 1 1 1 1 1 1 1 1 1 1
1 0 1 0 1 0 1 0 1 0 1 0 1 0 1 0 1
1 2 1 1 1 1 1 1 1 1 1 1 1 1 1 1 1
1 0 1 0 1 0 2 BS 1 0 1 0 1 0 1 0 1 
1 1 1 1 1 1 2 2 1 1 1 1 1 1 2 2 1
1 0 1 0 1 0 1 0 1 0 1 0 1 0 2 X 1
1 1 1 1 1 1 1 1 1 1 1 1 1 1 1 1 1

<map6>
1 1 1 1 1 1 1 1 1 1 1 1 1 1 1 1 1
1 0 1 0 1 0 1 0 1 0 2 0 1 0 1 0 1
1 1 1 1 1 1 1 1 1 1 1 1 1 1 1 1 1 
1 0 1 0 1 0 1 0 1 0 1 0 1 YH 2 0 1
1 1 2 2 1 1 1 1 1 1 1 1 1 2 2 1 1
1 0 2 GT 1 0 1 0 1 0 1 0 1 0 1 0 1
1 1 1 1 1 1 1 1 1 1 1 1 1 1 1 1 1
1 0 1 0 1 0 1 0 1 0 1 0 1 0 1 0 1
1 1 1 1 1 1 1 1 1 1 1 1 1 1 1 1 1
1 0 1 0 1 0 1 0 1 0 1 0 1 0 1 0 1
1 1 1 1 1 1 1 1 1 1 1 1 1 2 2 1 1
1 0 1 0 1 0 1 0 1 0 1 0 1 BS 2 0 1
1 2 1 1 1 1 1 1 1 1 1 1 1 1 1 1 1 
1 0 1 0 1 0 2 RC 1 0 1 0 1 0 1 0 1
1 1 1 1 1 1 2 2 1 1 1 1 1 1 2 2 1
1 0 1 0 1 0 1 0 1 0 1 0 1 0 2 X 1
1 1 1 1 1 1 1 1 1 1 1 1 1 1 1 1 1

<map7>
1 1 1 1 1 1 1 1 1 1 1 1 1 1 1 1 1
1 0 1 0 1 0 1 0 1 0 2 0 1 0 1 0 1
1 1 1 1 1 1 1 1 1 1 1 1 1 1 1 1 1
1 0 1 0 1 RH 2 0 1 0 1 0 1 0 1 0 1 
1 1 1 1 1 2 2 1 1 1 1 1 1 1 1 1 1
1 0 1 0 1 0 1 0 1 0 1 0 1 0 1 0 1
1 1 1 1 1 1 1 1 1 1 1 1 1 1 1 1 1
1 0 2 GS 1 0 1 0 1 0 1 0 1 0 1 0 1
1 1 2 2 1 1 1 1 1 1 1 1 2 2 1 1 1
1 0 1 0 1 0 1 0 1 0 1 0 2 YT 1 0 1 
1 2 1 1 1 1 1 1 1 1 1 1 1 1 1 1 1
1 0 1 0 1 0 1 0 1 0 1 0 1 0 1 0 1
1 1 1 1 1 1 1 1 1 1 1 2 2 1 1 1 1
1 0 1 0 1 0 1 0 1 0 1 0 2 0 1 0 1
1 1 1 1 1 1 1 1 1 1 1 1 1 1 2 2 1
1 0 1 0 1 0 1 Rain 2 0 1 0 1 BC 2 X 1
1 1 1 1 1 1 1 2 2 1 1 1 1 1 1 1 1


<map8>
1 1 1 1 1 1 1 1 1 1 1 1 1 1 1 1 1
1 0 1 0 1 0 1 0 2 0 1 0 1 0 1 0 1
1 1 1 1 1 1 1 1 1 1 1 1 1 1 1 1 1 
1 0 1 0 1 0 1 0 1 0 1 0 2 BC 1 0 1
1 1 1 1 1 1 1 1 1 1 1 1 2 2 1 1 1
1 0 1 0 1 0 1 0 1 0 1 0 1 0 1 0 1
1 1 1 2 2 1 1 1 1 1 1 1 1 1 1 1 1
1 0 1 YT 2 0 1 0 1 0 1 0 1 0 1 0 1
1 1 1 1 1 1 1 1 1 1 2 2 1 1 1 1 1
1 0 1 0 1 0 1 0 1 0 2 GS 1 0 1 0 1
1 1 1 1 1 1 1 1 1 1 1 1 1 1 1 1 1
1 0 1 0 1 RH 2 0 1 0 1 0 1 0 1 Rain 2
1 1 1 1 1 2 2 1 1 1 1 1 1 1 1 2 2
1 0 1 0 1 0 1 0 1 0 1 0 1 0 1 0 1
1 2 1 1 1 1 1 1 1 1 1 1 1 1 2 2 1 
1 0 1 0 1 0 1 0 1 0 1 0 1 0 2 X 1
1 1 1 1 1 1 1 1 1 1 1 1 1 1 1 1 1
